#############--##############
#                           #
#                           #
#                           #
#                           #
#                           #
#                           #
#                           #
#                           #
#                           #
#                           #
#                           #
#                           #
#                           #
-                           -
-                           -
#                           #
#                           #
#                           #
#                           #
#                           #
#                           #
#                           #
#                           #
#                           #
#                           #
#                           #
#                           #
#                           #
# P                         #
############--###############
