#########  #########
#                  #
#                  #
#                  #
#        P         #
#                  #
#                  #
#                  #
                    
                    
#                  #
#                  #
#                  #
#                  #
#                  #
#                  #
#                  #
#                  #
#                  #
#########  #########
