#########  #########
#                  #
# #######  ####### #
#                  #
# #      P       # #
# #  #        #  # #
# ####        #### #
# #     #  #     # #
        #  #        
        #  #        
# #     ####     # #
# #              # #
# #              # #
# #### #   # ##### #
# #    #   #     # #
# #  ###   ###   # #
# #              # #
# # ####   ##### # #
#                  #
#########  #########
